cv|c|v
cvan|c|van
cyan|c|ian
cyang|c|iang
cyao|c|iao
cyi|c|i
cyie|c|ie
cyin|c|in
cying|c|ing
cyou|c|iou
fong|f|ong
fou|f|ou
gi|g|i
gia|g|ia
giai|g|iai
gian|g|ian
giang|g|iang
giao|g|iao
gie|g|ie
gin|g|in
ging|g|ing
giu|g|iu
gv|g|v
gvan|g|van
gvn|g|vn
gvo|g|vo
hi|h|i
hia|h|ia
hiai|h|iai
hian|h|ian
hiang|h|iang
hiao|h|iao
hie|h|ie
hin|h|in
hing|h|ing
hiong|h|iong
hiu|h|iu
hvan|h|van
hvo|h|vo
ki|k|i
kian|k|ian
kiang|k|iang
kiao|k|iao
kin|k|in
king|k|ing
kiu|k|iu
kuo|k|uo
kv|k|v
kvan|k|van
kvn|k|vn
kvo|k|vo
lui|l|ui
lvan|l|van
lvn|l|vn
lvo|l|vo
mong|m|ong
ngan|ng|an
nge|ng|e
ngi|ng|i
ngian|ng|ian
ngie|ng|ie
ngin|ng|in
nging|ng|ing
ngu|ng|u
nguai|ng|uai
nguo|ng|uo
ngv|ng|v
ngvan|ng|van
ngve|ng|ve
ngvo|ng|vo
nui|n|ui
nun|n|un
pong|p|ong
sv|s|v
svan|s|van
sve|s|ve
svn|s|vn
syan|s|ian
syang|s|iang
syao|s|iao
sye|s|ie
syi|s|i
syin|s|in
sying|s|ing
wfan|wf|an
wfang|wf|ang
wfen|wf|en
wfu|wf|u
yong||iong
yuo||vo
zv|z|v
zvn|z|vn
zye|z|ie
zyi|z|i
zyin|z|in
zying|z|ing
zyou|z|iou
cuang|c|uang
ngiai|ng|iai
kiai|k|iai
ngai|ng|ai
ngiao|ng|iao
ngui|ng|uei